########
#X.....#
#@.....#
#....@.#
#......#
#*...*.#
#......#
########