########
#X.....#
#.@....#
#.@#.*.#
#....*.#
########