#######
#*.#..#
#..@..#
#*.@#X#
#..@..#
#*.#..#
#######